111111111111111
1CCCPCCCCCC01C1
1CCCCCCCCCC11C1
1CCCC1CCCCC11C1
1CCCCCCCCCCC1C1
1CCCCCCCCCC11E1
111111111111111