111111111111111
1000P0000000001
100000000C01101
100001000001101
100000000000101
100000000001CE1
111111111111111