1111111
1E01111

11C0111
1110P11
1111111