1111111111111
1E010000000C1
1000011111001
10001100000P1
1C11C11111111
1111111111111