1111111111111
10010000000C1
1000011111001
10001100000P1
1111E11111111
1111111111111