1111111111111
1E010000000C1
1000011111001
100011000111111100P1
1C11C11111111
11111111111111