1111111111111
1P0CC00E11111
1111111111111