1111111111
1000000001
1000P00001
1000000E01
1111111111
