1111111111111
1PNCC00E11111

1CCCC00N11111
1111111111111