1111111111111
1PNCC00111111
1CNCCE0N11111
1111111111111