1111111111111
1PNCC00E11N11
1111111111111