1111111111111
1EC1000000011
1P0N011111001
10001100011111110011
1111111111111
11111111111111