1111111111
1P00000001
1000000001
1000N00E01
1111111111
