1111111111111
1PCCC00E11111
1111111111111