1111111111
1C0000N001
100N000001
1000000E01
1111111111
