111111111111111
1PNCC00E11111C1
1CCCC00N11111C1
111111111111111