111111111
10PCN1111
1000000E1
111111111