111111111111111
1CCCPCCCCCC00C1
1CCCCCCCCCCNNC1
1CCCCNCCCCCNNC1
1CCCCCCNCCCCNC1
1CCCCCCCCCCNCE1
1NNNNNNNNNNNNN1
111111111111111